x3133313333111111333133313333111111100000000000-
13131313113113333313131313113113333100000000000-
13131313113113113313131313113113113y00000000000-
13131313113113113113131313113113113100000000000-
13131313113113113113131313113113113100000000000-
13131313113113113113131313113113113100000000000-
13331333113333113113331333113333113100000000000-
13133313333111113113133313333111113100000000000-
13131313113113333113131313113113333100000000000-
13131313113113111113131313113113111100000000000-
13131313113113111113131313113113111100000000000-
13131313113113111113131313113113111100000000000-
13131313113113111113131313113113111100000000000-
13131313113113111113131313113113111100000000000-
13131313113113111113131313113113111100000000000-
13131313113113111113131313113113111100000000000-
13331333113333111113331333113333111100000000000-
11111111111111111111111111111111111100000000000-
11111111111111111111111111111111111100000000000-
11111111111111111111111111111111111100000000000