x31333133331111111x31333133331111111x3133313333111-
13131313113113333113131313113113333113131313113113-
13131313113113113y13131313113113113y13131313113113-
13131313113113111113131313113113113y13131313113113-
13131313113113111113131313113113113y13131313113113-
13131313113113111113131313113113113y13131313113113-
13331333113333111113131313113113113y13131313113113-
13131313113113111113131313113113113y13131313113113-
13331333113333111113131313113113113y13131313113113-
13131313113113111113131313113113113y13131313113113-
13331333113333111113131313113113113y13131313113113-
13131313113113111113131313113113113y13131313113113-
13331333113333111113131313113113113y13131313113113-
13131313113113111113131313113113113y13131313113113-
13331333113333111113131313113113113y13131313113113-
13131313113113111113131313113113113y13131313113113-
13331333113333111113131313113113113y13131313113113-
13131313113113333113131313113113333113131313113113-
13131313113113333113131313113113333113131313113113-
11111111111111111113131313113113113y13131313113111