x31333133331111111-
131313131131133331-
13131313113113113y-
131313131131131111-
131313131131131111-
131313131131131111-
133313331133331111-
111111111111111111